&|&|&|&&&|&|||&&&|&&|||&||&||&|&&|||||&|&|&&&&||||&&&|&|&&||||&&&|&&|||&&|&&&|||

&&||&&&|&||&&&||&|||&&&|&||&&&|||||||&&&&|&&||&||&&|||&|&&&&&&|&|||&&||&|||&&|&|

&|&|&&&&|&&&|&|||&&&||||||&&|&&&&|&&|&&&|&||&|&&|||&&&|&&&&&|&&&&&&||&|&&||&&|&&

&|&&|||||&&&&||&&&||||&&&&|||||&||&|&|&|&||&|&&|&|&||||||&&||||||&|&&|&&&&&&||||

&||&&||&|&||&|&|&&&&&||&&&&&&&||&&|&&||&|&|&|&&&&|&&|||||&&&||||&||&&&|||&&&|||&

&&&&|&&|&|&&&|||&&&||||&|&|&&|&&&|&&&|||&|&&&|&|&&&|&&|||&|&|&|&|&&|&&&&|&&|||||

&&|&|&||||&||||&&|||&&&|||&&||&|&|||&||&&&||||&|&|&&|&&&|&&&|&&|&||&|&&&|&&&||||

&&&||||&&&&&|&|&&&&||&&|&|||&&&||&&&&|&&&|&&|&||&|&&|&||||&|&|||&|&||&||&|&&&&||

&&&|&&&||&||&||&|&|&||&&&|||||&|&&||&&&|||&|||||||&&|||&&||&|&|&|&|&&&&&&||&|&||

&&||&&|&&|||||&&&||&|&|&|&|&||&|&||&&&&||||&|&|||||||&|&&&&|&&|||||&|&||&&&||&|&
